###############################################################################
#
# The Forge of Golems (youredoomed)
#
###############################################################################

{{
function golemforge_portal(e)
  local timeout_turns = crawl.random_range(600, 800)

  local messager =
    timed_msg {
      initmsg = { "You hear a sound of hammering.",
                  "There is an entrance to the golemforge on this level. "
                  .. "Hurry and find it before the portal disappears!" },
      finalmsg = "A sound of hammering is finaly fades away.",
      verb = 'ringing',
      noisemaker = 'sound of hammering',
      ranges = {
        { 5000, 'faint ' },  { 4000, '' },
        { 2500, 'steady ' }, { 1500, 'quick ' },
        { 0, 'loud ' }
      }
    }

  e.lua_marker('O',
      timed_marker {
        disappear = "The gateway is sealed and disappears.",
        entity = 'gateway',
        turns = timeout_turns,
        single_timed = true,
        floor = "expired_portal",
        feat_tile = "dngn_portal_golem_gone",
        msg = messager })
  e.tags("uniq_golemforge chance_golemforge")
  e.chance(500)
  e.kfeat("O = enter_golem")
  e.kfeat("X = permarock_wall")
  e.kfeat("x = crystal_wall")
  e.rtile("x = dngn_crystal_lightblue")
  e.colour("X = blue")
  e.colour(".1234x = lightblue")
  e.ftile(".'12345O+xX = floor_crystal_squares")
end

function golemforge_appearance(e)
  e.kprop("aABbCcD+xXLrmh = no_tele_into")
  e.kfeat("< = exit_golem")
  e.kfeat("X = permarock_wall")
  e.kfeat("x = crystal_wall")
  e.rtile("x_ = dngn_crystal_lightblue")
  e.colour("X = blue")
  e.colour(".x_ = lightblue")
  e.ftile(".aABbCcDO+xX = floor_crystal_squares")
end

function callback.golemforge_prevent_spamming(data, triggerable,
                                         triggerer, marker, ev)

  if triggerer.type ~= "turn" or triggerer.sub_type ~= "countdown" then
    return
  end

  if dgn.persist.golemforge_check_spamming == true then
    return
  end

  dgn.persist.golemforge_check_spamming = true

  local x, y = marker:pos()

  for p in iter.slave_iterator("feat_remove", 1) do
    dgn.terrain_changed(p.x, p.y, "floor_crystal_squares", false)
  end

  local nguard = 0
  local guardarray = {}
  local wander = mons.behaviour("wander")
  for p in iter.slave_iterator("guard_place", 1) do
    local guard = dgn.create_monster(p.x, p.y, "generate_awake electric golem \
            hd:16 hp:1500 perm_ench:flight \
            col:yellow name:barrier_golem n_rpl n_des n_spe \
            tile:mons_golemforge_barrier_golem \
            spells:mass_barrier.33.magical;blinkbolt.33.magical;lightning_bolt.33.magical")
    if guard then
      nguard = nguard + 1
      guardarray[nguard] = guard
    end
  end
  view.update_monsters()
  for i = 1, nguard do
    local guard = guardarray[i]
    guard.beh = wander
  end
  crawl.mpr("You hear the walls rumbling! You feel something dangerous...", "warning")
end

}}
# Entries ##########################################
default-depth: Elf, Depths:1-4

NAME:   portal_golemforge_entry
TAGS:   transparent
DEPTH:  Elf, Depths:1-4
: golemforge_portal(_G)
: set_feature_name("crystal_wall", "wall of crystal")
MAP
     .
    x.x
  xxx.xxx
 xx.....xx
.....O.....
 xx.....xx
  xxx.xxx
    x.x
     .
ENDMAP

# The destination Depths:1-4s ############

default-depth: Golemforge

NAME:   golemforge_statue_garden_chambered
TAGS:   no_item_gen no_mons_gen no_trap_gen
ORIENT: encompass
KMONS: y = crystal guardian
KMONS: i = iron golem
KMONS: G = iron golem col:lightred name:orange_crystal_golem n_rpl n_des n_spe \
            tile:mons_golemforge_crystal_golem \
            spells:brain_feed.24.natural;draining_gaze.24.natural
KMONS: P = iron golem col:green name:plutonium_golem n_rpl n_des n_spe \
            tile:mons_golemforge_plutonium_golem spells:corrupting_pulse.30.natural
KMONS: F = iron golem perm_ench:inner_flame col:red name:lava_golem n_rpl n_des n_spe \
            tile:mons_golemforge_lava_golem \
            spells:bolt_of_magma.24.natural;sticky_flame.100.natural.instant
KMONS: S = lightning spire hd:12 col:lightgreen name:repair_machine n_rpl n_des n_spe \
            tile:mons_golemforge_repair_machine \
            spells:aura_of_healing.70.magical;warning_cry.30.magical

KMONS: m = animated armour tile:mons_golemforge_armour_golem spells:none \
            ; double sword randart . buckler randart |\
            broad axe randart . shield randart |\
            eveningstar randart . large shield randart |\
            demon trident randart . javelin ego:silver q:4 |\
            lajatang randart . throwing net q:1 |\
            quick blade randart . dart ego:curare q:20 |\
            longbow randart. arrow q:40 |\
            triple crossbow randart . bolt q:40 |\
            fustibalus randart . sling bullet q:40 |\
            triple sword randart | bardiche randart |\
            executioner's axe randart | great mace randart .\
            crystal plate armour randart | robe randart |\
            fire dragon scales randart | ice dragon scales randart | storm dragon scales randart |\
            pearl dragon scales randart | swamp dragon scales randart | steam dragon scales randart |\
            acid dragon scales randart | shadow dragon scales randart | quicksilver dragon scales randart
SHUFFLE:  GPF
FTILE:  iyGPFSmAaBbCcDt = floor_crystal_squares
COLOUR: iyGPFSmAaBbCcDt = lightblue
KFEAT:  Lm = lava
TILE:  Lm = dngn_golemforge_furnace
KFEAT:  A = stone_arch
KFEAT:  h = abandoned_shop
KFEAT:  t = clear_permarock_wall
COLOUR: t = yellow
{{
dgn.persist.golemforge_check_spamming = false
local tm = TriggerableFunction:new{func="callback.golemforge_prevent_spamming",
                                   repeated = true}
tm:add_triggerer(DgnTriggerer:new { type="turn", delay_min=100000, delay_max=120000})
lua_marker('t', tm)
lua_marker('_', props_marker {guard_place = 1})
lua_marker('t', props_marker {feat_remove = 1})
}}
KITEM: a = randbook disc:necromancy slevels:16 / randbook disc:conjuration slevels:16 / \
        randbook disc:summoning slevels:16 / randbook disc:charms slevels:16 / \
        randbook disc:hexes slevels:16 / randbook disc:translocation slevels:16 / \
        randbook disc:transmutation slevels:16 / randbook disc:fire slevels:16 / \
        randbook disc:air slevels:16 / randbook disc:earth slevels:16 / \
        randbook disc:ice slevels:16 / randbook disc:poison slevels:16
KITEM: B = triple sword good_item randart no_pickup / double sword good_item randart no_pickup / \
        great mace good_item randart no_pickup / eveningstar good_item randart no_pickup / \
        bardiche good_item randart no_pickup / demon trident good_item randart no_pickup / \
        executioner's axe good_item randart no_pickup / broad axe good_item randart no_pickup / \
        lajatang good_item randart no_pickup / quick blade good_item randart no_pickup / \
        longbow good_item randart no_pickup / triple crossbow good_item randart no_pickup / \
        fustibalus good_item randart no_pickup
KITEM: b = large rock q:20 no_pickup / javelin ego:silver q:20 no_pickup / \
        sling bullet q:100 no_pickup / dart ego:curare q:20 no_pickup
KITEM: C = crystal plate armour good_item randart no_pickup / \
        robe good_item randart no_pickup / \
        fire dragon scales good_item randart no_pickup / \
        ice dragon scales good_item randart no_pickup / \
        storm dragon scales good_item randart no_pickup / \
        pearl dragon scales good_item randart no_pickup / \
        swamp dragon scales good_item randart no_pickup / \
        steam dragon scales good_item randart no_pickup / \
        acid dragon scales good_item randart no_pickup / \
        shadow dragon scales good_item randart no_pickup / \
        quicksilver dragon scales good_item randart no_pickup
KITEM: c = pair of gloves good_item randart no_pickup / \
        pair of boots good_item randart no_pickup / \
        helmet good_item randart no_pickup / \
        cloak good_item randart no_pickup / \
        naga barding good_item randart no_pickup / \
        centaur barding good_item randart no_pickup / \
        large shield good_item randart no_pickup
KITEM: D = any randart jewellery no_pickup
: golemforge_appearance(_G)
: set_feature_name("crystal_wall", "wall of crystal")
: set_feature_name("lava", "arcane furnace")
: set_feature_name("clear_permarock_wall", "strange container")
MAP
XXXXXXXXXXXXXXXXXXXXXXXXXXXXXXXXXXXXXXXXXXXXXXXXXXXXXXXXXXXXXXXXXXXXXX
XXXXXXXXXXXXxxxxxxxxxxXXXXXXXXXXXXXXXXXXXXXXXXXxxxxxxxxxxxxxXXXXXXXXXX
XXXXXXxxxxxxxx......xxxXXXXXXXXXXXXXXXXXXXXXXxxxx.........xxxXXXXXXXXX
XXXXXXxA...xx........xxxxXXXXXXXXXXXXXXXXXXxxx.............xxxxXXXXXXX
XXXXXxx.................xxxXXXXXXXXXXXXXXXxxx........P........xxxXXXXX
XXXXXXxxx.............i...xxxXXXXxxxXXXXxxx...i.............i...xxxXXX
XXXXXXxxx............ySy....xxxxxxtxxxxxx....ySy...........ySy....xXXX
XXXxxxx...............i..........._...........i.............i.....xXXX
XXxxx.........LLL...................................LLL...........xXXX
XXx..........LLLLL.................................LLLLL..........xXXX
XXx..........LLmLL................S................LLmLL....F.....xXXX
XXx..........LLLLL.................................LLLLL..........xXXX
XXx...........LLL...................................LLL...........xXXX
XXx.....i.............i.........iL.Li.........i.............i.....xXXX
XXx....ySy...........ySy....xxxxxx+xxxxxx....ySy...........ySy....xXXX
XXxxx...i.............i...xxxXXXXxLxXXXXxxx...i.............i...xxxXXX
XXXXxxx.................xxxXXXXXXxLxXXXXXXxxx........G........xxxXXXXX
XXXXXXxxx.............xxxXXXXXXXXxLxXXXXXXXXxxx.............xxxXXXXXXX
XXXXXXXXxxx.........xxxXXXXXXXXXXxLxXXXXXXXXXXxxx.........xxxXXXXXXXXX
XXXXXXXXXXxx.......xxxXXXXXXXXXxxxLxxxXXXXXXXXXxxx.......xxXXXXXXXXXXX
XXXXXXXXXXxt_......xXXXXXXXXXXxxLLLLLxxXXXXXXXXXXx......_txXXXXXXXXXXX
XXXXXXXXXXxx.......xXXXXXXXXxxxLLx+xLLxxXXXXXXXXXx.......xxXXXXXXXXXXX
XXXXXXXxxxx.......ixXXXXXxxxxxLLxxLxxLLxxxxxXXXXXxi.......xxxxxXXXXXXX
XXXXXXxx..........LxxxxxxxxxxLLxxLmLxxLLxxxxxxxxxxL..........xxxXXXXXX
XXXXXXx.y..........+LLLLLLLLLLL+LmmmL+LLLLLLLLLLL+...........y.xXXXXXX
XXXXXXx..S........LxxxxxxxxxxLLxxLmLxxLLxxxxxxxxxxL.........S..xXXXXXX
XXXXXXx.y.........ixXXXXXXXXxxLLxx+xxLLxxxxxXXXXXxi..........y.xXXXXXX
XXXXXXxx...........xXXXXXXXXXxxLLxLxLLxxXXXXXXXXXx...........xxxXXXXXX
XXXXXXXxxx.........xxXXXXXXXXXxxLLLLLxxXXXXXXXXXxx..........xxxXXXXXXX
XXXXXXXXXxx.........xxxxXXXXXXXxxxLxxxXXXXXXXxxxx.........xxxXXXXXXXXX
XXXXXXXXXXxx...........xxXXXXXXxxLLLxxXXXXXXxx...........xxXXXXXXXXXXX
XXXXXXXXXXxx..........y.xXXXXXXxLmmmLxXXXXXXx.y..........xxXXXXXXXXXXX
XXXXXXXXXXxt..y......S..xXXXXXXxLmmmLxXXXXXXx..S......y..txXXXXXXXXXXX
XXXXXXXXXXxx..........y.xXXXXXXxLmmmLxXXXXXXx.y..........xxXXXXXXXXXXX
XXXXXXXXXXxx...........xxXXXXXXxxLLLxxXXXXXXxx...........xxXXXXXXXXXXX
XXXXXXXXXxx.........xxxxXXXXXXXxxxLxxxXXXXXXXxxxx.........xxxXXXXXXXXX
XXXXXXXxxx.........xxXXXXXXXXXxxLLLLLxxXXXXXXXXXxx..........xxXXXXXXXX
XXXXXXxx...........xXXXXXXXXXxxLLx+xLLxxXXXXXXXXXx...........xxxXXXXXX
XXXXXXx.y.........ixXXXXXxxxxxLLxxLxxLLxxxxxXXXXXxi..........y.xXXXXXX
XXXXXXx..S........LxxxxxxxxxxLLxxLmLxxLLxxxxxxxxxxL.........S..xXXXXXX
XXXXXXx.y..........+LLLLLLLLLLL+LmmmL+LLLLLLLLLLL+...........y.xXXXXXX
XXXXXXxx..........LxxxxxxxxxxLLxxLmLxxLLxxxxxxxxxxL..........xxxXXXXXX
XXXXXXXxxxx.......ixXXXXXXXXxxLLxx+xxLLxxXXXXXXXXxi.......xxxxXXXXXXXX
XXXXXXXXXXxx.......xXXXXXXXXXxxLLxLxLLxxXXXXXXXXXx.......xxXXXXXXXXXXX
XXXXXXXXXXxt_......xXXXXXXXXXXxxLLLLLxxXXXXXXXXXXx......_txXXXXXXXXXXX
XXXXXXXXXxxx.......xxxxxxXXXXXXxxxLxxxXXXXXXXxxxxx.......xxXXXXXXXXXXX
XXXXXXXXxxx.........xxxXXXXXXXXXXxLxXXXXXXXXXXxxx.........xxxXXXXXXXXX
XXXXXXxxx.............xxxXXXXXXXXxLxXXXXXXXXxxx.............xxxXXXXXXX
XXXXxxx........G........xxxXXXXXXxLxXXXXXXxxx........P........xxxXXXXX
XXxxx..y.i...........i.y..xxxXXXXxLxXXXXxxx..y.i...........i.y..xxxXXX
XXx.....S.............S.....xxxxxx+xxxxxx.....S.............S.....xXXX
XXx....i.y...........y.i........iL.Li........i.y...........y.i....xXXX
XXx...........LLL...................................LLL...........xXXX
XXx..........LLLLL.................................LLLLL..........xXXX
XXx....F.....LLmLL................S................LLmLL.....F....xXXX
XXx..........LLLLL.................................LLLLL..........xXXX
XXx....y.i....LLL....i.y.....................y.i....LLL...........xXXX
XXx.....S.............S..........._...........S...............xx..xXXX
XXxt...i.y...........y.i....xxxxxxtxxxxxx....i.y............x..xx.xXXX
XXxxx..........P..........xxxXXXXxxxXXXXxxx..........G......xx..xxxXXX
XXXXxxx.................xxxXXXXXXXXXXXXXXXxxx................xxhxXXXXX
XXXXXXxxx.............xxxXXXXXXXXXXXXXXXXXXXxxx.............xxx+xXXXXX
XXXXXXXXxxx.........xxxXXXXXXXXXXXXXXXXXXXXXXXxxx.........xxxXxCxXXXXX
XXXXXXXXXxxxxxxxxxxxxxXXXXXXXXXXXXXXXXXXXXXXXXXxxxxxxxxxxxxxXXxBxXXXXX
XXXXXXXXXXXXXXXXXXXXXXXXXXXXXXXXXXXXXXXXXXXXXXXXXXXXXXXXXXXXXXxDxXXXXX
XXXXXXXXXXXXXXXXXXXXXXXXXXXXXXXXXXXXXXXXXXXXXXXXXXXXXXXXXXXXXXxcxXXXXX
XXXXXXXXXXXXXXXXXXXXXXXXXXXXXXXXXXXXXXXXXXXXxxxxxxxxxxxxxxxxxxxCxXXXXX
XXXXXXXXXXXXXXXXXXXXXXXXXXXXXXXXXXXXXXXXXXXXx<DacBbDaCBaDcbBaBbcxXXXXX
XXXXXXXXXXXXXXXXXXXXXXXXXXXXXXXXXXXXXXXXXXXXxxxxxxxxxxxxxxxxxxxxxXXXXX
XXXXXXXXXXXXXXXXXXXXXXXXXXXXXXXXXXXXXXXXXXXXxXXXXXXXXXXXXXXXXXXXXXXXXX
ENDMAP