###############################################################################
# ecumenical.des: This file contains the vaults that place faded altars and
#                 are a part of the D:1-3 chance group for placing such an
#                 altar. Vaults that use ecumenical altars for decorative
#                 reasons should not be in this file.
#
# See the section in docs/develop/levels/guidelines.md for guidelines on
# creating new vaults. Every vault in this file should call
# ecumenical_altar_setup to set the chance.
#
###############################################################################

{{
function ecumenical_altar_setup(e)
  e.depth("D:1-3")
  e.tags("uniq_ecumenical_altar chance_ecumenical_altar extra")
  e.chance(5000)
  e.kfeat("_ = altar_ecumenical")
end
}}

NAME:   basic_ecumenical_altar
TAGS:   transparent
WEIGHT: 200
: ecumenical_altar_setup(_G)
MAP
_
ENDMAP

NAME:    chequers_ecumenical_altar_simple
TAGS:    transparent
SHUFFLE: GH
SUBST: G : Gbt x:5
: ecumenical_altar_setup(_G)
MAP
.....
.HGH.
.G_G.
.HGH.
.....
ENDMAP

NAME:    chequers_ecumenical_altar_simple_redux
TAGS:    transparent
SHUFFLE: GH
SUBST:   G : Gbt x:5
: ecumenical_altar_setup(_G)
MAP
.......
..HGH..
.HGHGH.
.GH_HG.
.HGHGH.
..HGH..
.......
ENDMAP

NAME:   chequers_ecumenical_altar_grove
TAGS:   transparent
WEIGHT: 5
KMASK:  - = no_item_gen
KMASK:  - = no_monster_gen
KPROP:  - = no_tele_into
SUBST:  - = tt.
: if crawl.one_chance_in(4) then
: set_feature_name("tree", "dead tree")
TILE:    t = dngn_tree_dead
COLOUR: t = w:5 lightgrey / w:5 darkgrey / brown
: elseif crawl.one_chance_in(4) then
COLOUR: t = lightred / red w:4 / yellow w:4
TILE:   t = dngn_tree_lightred / dngn_tree_red w:4 / dngn_tree_yellow w:4
: end
: ecumenical_altar_setup(_G)
MAP
 ......
 .-.-.@..
--.-..-.--.
 .tttttt.--.
.-t-...t.---.
.tt.-tt.-t--.
-t--.-t--t-.
 ttt-.ttttt-.
 t.t.-.-t-t.
 -t._tttt-@.
 ttttt--tt.
-ttt--.---.
...........
ENDMAP

NAME: chequers_ecumenical_altar_lobes
WEIGHT: 5
KPROP:  tG = no_tele_into
KMASK:  tGp = no_item_gen
KMASK:  tG = no_monster_gen
NSUBST: + = 1:.
SUBST:  ' : tGp, t = t:2 ., G = G:3 ., p = p:5 ., - = T U V .
KMONS: p = plant
: ecumenical_altar_setup(_G)
MAP
   xxxxx    xxxxx
 xxx'-'xxxxxx'-'xxx
xxtGp_pGtxxtGp.pGtxx
xxtGp.pGtxxtGp.pGtxx
xxtGp.pGtxxtGp.pGtxx
xxxxx+xxxxxxxx+xxxxx
xtGpp..........ppGtx
xxxtGpppp..ppppGtxxx
  xxxxxtG..Gtxxxxx
      xxx..xxx
        x..x
         @@
ENDMAP

NAME: chequers_ecumenical_altar_twisty
TAGS: transparent
WEIGHT: 5
KFEAT:  _ = altar_ecumenical
SUBST: x : x:30 c t:1
: ecumenical_altar_setup(_G)
MAP
 x@x
 x.xx
 xx.x
xx.xx
x.xx
xx_xx
 xx.x
xx.xx
x.xx
xx.x
 x@x
ENDMAP

NAME: chequers_ecumenical_altar_island
SUBST: - = W:5 . t:5
SUBST: s = W:5 .
SUBST: S = w.
: ecumenical_altar_setup(_G)
MAP
sssssssssssss
sSSSSSSSSSSSs
sSwwwwwwwwwSs
sSwwwwwwwwwSs
sSwWWWWwwwwSs
sSWww--WwwwSs
sSwWw-_-wwwSs
sSwWw---wwwSs
@.WwwwwwwwwSs
sSwwwwwwwwwSs
sSwwwwwwwwwSs
sSSSSSSSSSSSs
sssssssssssss
ENDMAP

NAME:   ebering_ecumenical_altar_webs
TAGS:   transparent
NSUBST: ^ = 4=^. / 4=^..
KFEAT:  ^ = web trap
: ecumenical_altar_setup(_G)
MAP
^^^
^_^
^^^
ENDMAP

NAME: ebering_ecumenical_altar_mist
TAGS:   transparent
MARKER: _ = lua:fog_machine { cloud_type = "thin mist", pow_min = 5, \
                              pow_max = 10, delay = 20, size = 1, \
                              spread_rate = 15, walk_dist = 2 }
: ecumenical_altar_setup(_G)
MAP
...
._.
...
ENDMAP

NAME:  ebering_ecumenical_altar_box
TAGS:  transparent
SUBST:  x : xcvb
: ecumenical_altar_setup(_G)
MAP
.......
.xx.xx.
.x...x.
..._...
.x...x.
.xx.xx.
.......
ENDMAP

NAME:  ebering_ecumenical_altar_hall
TAGS:  transparent
SUBST: G : btAGTUV Y:1
: ecumenical_altar_setup(_G)
MAP
xxxxxxx
xGxGxGx
@.._..@
xGxGxGx
xxxxxxx
ENDMAP

NAME:  ebering_ecumenical_altar_sacrificial
TAGS:  transparent
KITEM: _ = dagger mundane
SUBST: ' = ''.
KPROP: ' = bloody
: ecumenical_altar_setup(_G)
MAP
'''''
'''''
''_''
'''''
'''''
ENDMAP

NAME:   ebering_ecumenical_altar_rust
TAGS:   transparent
KITEM:  _ = any weapon damaged
KFEAT:  a = iron_grate
NSUBST: ' = 2=va / 4=va. / .
: ecumenical_altar_setup(_G)
MAP
'''
'_'
'''
ENDMAP

NAME:  ebering_ecumenical_altar_abandoned
TAGS:  transparent
KFEAT: s = abandoned_shop
: ecumenical_altar_setup(_G)
MAP
._.
...
V.S
ENDMAP

NAME:   ebering_ecumenical_altar_ruins
WEIGHT: 5
TAGS:   transparent
SUBST:  G = GGG-
SUBST:  - = --.
COLOUR: - = brown
FTILE:  -G = floor_rough_brown
COLOUR: G = lightgrey
TILE:   G = dngn_crumbled_column
: set_feature_name("granite_statue", "broken pillar")
: ecumenical_altar_setup(_G)
MAP
  G-G
  .-.
G.G-G.G
---_---
G.G-G.G
  .-.
  G-G
ENDMAP

NAME:    shapermc_ecumenical_altar_notcrosses
TAGS:    no_monster_gen transparent
SHUFFLE: PQ
SUBST:   P : cvb
SUBST:   Q : mmWWl
: ecumenical_altar_setup(_G)
MAP
ccccc+ccccc
c....P....c
c..QQPQQ..c
c....P....c
c....P....c
c.QQQ_QQQ.c
c....P....c
c....P....c
c..QQPQQ..c
c....P....c
ccccc+ccccc
ENDMAP

NAME:  shapermc_ecumenical_altar_starsandcircs
TAGS:  no_monster_gen no_pool_fixup transparent
SUBST: P : xxxxxccl
SUBST: Q : WWW'l
KPROP: ' = bloody
: ecumenical_altar_setup(_G)
MAP
     ..@..
    .PP.PP.
   .P.Q.Q.P.
  .P..Q.Q..P.
 .PQQQQ.QQQQP.
.P..Q.QwQ.Q..P.
.P...Qw_wQ...P.
.P...Qw.wQ...P.
.P...Q.w.Q...P.
.P..Q.Q.Q.Q..P.
 .PQ.Q...Q.QP.
  .@Q.....Q@.
   .P.....P.
    .PPPPP.
     .....
ENDMAP

NAME:   shapermc_ecumenical_altar_totnotflames
COLOUR: . = green / brown
TAGS:   no_monster_gen transparent
FTILE:  A. = floor_grass:20 / floor_dirt
SUBST:  A = ATUV
: ecumenical_altar_setup(_G)
MAP
    @t@
    t.t
   tt.t
   t..t  t
   t.tt tt@
   t.t  t.t
   t.tttt.t
   t..tt..t
    t.t.ttt
@tt t...t
t.ttt.A.tttt@
t...t...tt..t
tt........ttt
 tt..G_G.tt
  tttttttt
ENDMAP

NAME:   shapermc_ecumenical_altar_gd
TAGS:   no_monster_gen transparent
KMONS:  P = plant / fungus
KMONS:  D = demonic plant / withered plant w:5
NSUBST: ' = 15:P / 10:P.. / .
NSUBST: - = 15:D / 10:D.. / .
SUBST:  x : ccccvvbb
: ecumenical_altar_setup(_G)
MAP
     .xxxxxxxxx.
  .xxx''''x----xxx.
  x'''''''x-------x
 xx'''''''x-------xx.
x'''''''''x---------x
x'''''''''_---------x
x'''''''''x---------x
.xx'''''''x-------xx.
  x'''''''x-------x
  .xxx''''x----xxx.
     .xxxxxxxxx.
ENDMAP

NAME:   shapermc_ecumenical_altar_hornbeckon
TAGS:   no_monster_gen transparent
KMONS:  p = plant
KMONS:  f = fungus
NSUBST: ' = 8:pf / 12=ppf... / .
: ecumenical_altar_setup(_G)
MAP
....@....
bxxbWbxxb
x'''W'''x
x''W'''xx
xx'W''xx
 x'W'xx
 x'W'x
 xxW'xx
  x'W'x
  xx-Wxx
   x''Wx
   x''Wxxxx
   xx''._Gx
    xxxxxxx
ENDMAP

NAME:    shapermc_ecumenical_altar_venn
TAGS:    no_monster_gen transparent
SHUFFLE: GV
SUBST:   x : xxxxccvb
: ecumenical_altar_setup(_G)
MAP
 .xxx.
.x...x
x..V.Gx
x.V..xxx
x...xAxGx.
.xGx_x...x
  xxx..V.x
   xG.V..x
    x...x.
    .xxx.
ENDMAP

NAME:   shapermc_ecumenical_altar_flowoftime
TAGS:   no_monster_gen transparent
MONS:   plant
MONS:   withered plant
MONS:   demonic plant
SUBST: ' = P.....
SUBST: - = PPPPP.
: if crawl.one_chance_in(20) then
SUBST:  P : 2223
: else
SUBST:  P = 11222
: end
: ecumenical_altar_setup(_G)
MAP
xxb+bxx
x'''''x
x'''''x
x'''''x
x'''''x
xb'''bx
xbb'bbx
xbb_bbx
xbb-bbx
xb---bx
x-----x
x-----x
x-----x
x-----x
xxb+bxx
ENDMAP

NAME:   dilly_ecumenical_altar_deadguardian
TAGS:   no_monster_gen transparent
MONS:   plant
SUBST: z = t11
KITEM: E = never_decay human skeleton / gnoll skeleton / elf skeleton / dwarf skeleton
: dgn.delayed_decay(_G, "e","hoblin skeleton / hobgoblin skeleton / kobold skeleton")
FTILE: 1et'_  = floor_grass
: ecumenical_altar_setup(_G)
MAP
         t      
        ttt     
       tt_t     
      tt'tt     
     tt'ztt     
     ttz'ttt    
    ttz'zztt     
   ttzzz'zztt    
  ttz'''''''tt   
  tt'xxx+xxx'tt  
  tt'x.....x'tt  
  ttex..G..xeet  
 tteex..E..xett  
  ttex.x.x.xtt   
   ttxxx+xxxtt   
ENDMAP
