##############################################################################
# tomb.des: Maps for the Tomb.
##############################################################################

##############################################################################
# Tomb entries

##############################################################################
# simple entrance
NAME:   tomb_entry_simple_bobbens
ORIENT: float
TAGS:   tomb_entry no_monster_gen no_item_gen
MONS:   guardian mummy
MONS:   sphinx
# crawl will rotate for the rest of possibilities
SHUFFLE: AB
SUBST:  A = +, B = c
KFEAT:  O = enter_tomb
MAP
cccc.cccc
c1.....1c
c.ccccc.c
c.c.2.c.c
..c.O.c..
c.c...c.c
c.cABcc.c
c1.....1c
cccc.cccc
ENDMAP

##############################################################################
# small pyramid leading to the bigger one
NAME:   tomb_entry_pyramid_bobbens
ORIENT: float
TAGS:   tomb_entry no_monster_gen
MONS:   sphinx
MONS:   w:1 mummy / w:9 guardian mummy
MONS:   mummy priest
SUBST:  ' = ~ .:50
KFEAT:  O = enter_tomb
MAP
........................
........................
..cccccccccccccccccccc..
..cccccccccccccccccccc..
..cc....2...........cc..
..cc..............2.cc..
..cc....cccccccccc''cc..
..cc....c''''''''c''cc..
..cc....c''ccccc'c''cc..
..cc....c''cO'3''c''cc..
..cc....c''ccccccc''cc..
..cc.2..c''2''''''''cc..
..cc....c'''''''''''cc..
..cc....cccccccccccccc..
..cc................cc..
..cc....2......2....cc..
..cc...ccc++++ccc...cc..
..cc...cc......cc...cc..
..cc.2.cc.G..G.cc.2.cc..
..cc.V.cc......cc.V.cc..
..cc...cc......cc...cc..
..ccccccc.G..G.ccccccc..
..ccccccc......ccccccc..
........................
.......1........1.......
........................
........................
ENDMAP

##############################################################################
# sphere entry
NAME:   tomb_entry_sphere_bobbens
ORIENT: float
TAGS:   tomb_entry no_monster_gen no_rotate
MONS:   w:1 mummy / w:9 guardian mummy
MONS:   sphinx
MONS:   mummy priest
KFEAT:  O = enter_tomb
MAP
          ccccc
       cccc.1.cccc
     ccc.........ccc
    cc......c......cc
   cc....ccccccc....cc
   c....cc.1.1.ccc..1c
..cccc...........cc..cc
.1c..cc...........c3O.c
..+..2ccccc.F.ccccccccc
.1c...c...............c
..cc..cc.............cc
   c...ccc.1..1.cc...c
   cc....cccccccc...cc
    cc......c......cc
     ccc.........ccc
       cccc.1.cccc
          ccccc
ENDMAP

##############################################################################
# forgotten tomb entrance
NAME:   tomb_entry_forgotten_bobbens
ORIENT: float
TAGS:   tomb_entry no_monster_gen
KFEAT:  f = .
# "withered plant" instead of "plant"
KMONS:  f = w:2 col:darkgrey plant name:withered name_adjective              \
            tile:mons_withered_plant / w:1 col:lightgrey plant name:withered \
            name_adjective tile:mons_withered_plant
SUBST:  p = f.
KFEAT:  O = enter_tomb
MAP
cccccccccc
cfffffppp.
cfOfffppp.
cffffppp..
cffpppp..
cppppp..
cppp...
cpp..
c...
ENDMAP

##############################################################################
# she sells tomb entry shells by the sea shore
NAME:   tomb_entry_shell_bobbens
TAGS:   tomb_entry no_monster_gen no_item_gen no_rotate
MONS:   guardian mummy
MONS:   mummy priest
KFEAT:  O = enter_tomb
MAP
          c
        ccc..
      ccc.c1.
    ccc......
   cc.....c1.
  cc......cccc
 cc.......c..ccc
 c........c....cc
cc1.......c.O2..c
c.....1...c.....c
c.....ccUcc.....c
cc.....ccc1.....c
 cc............cc
  ccc........1cc
    ccc.....ccc
      ccccccc
ENDMAP

##############################################################################
NAME: nicolae_tomb_entry_grand_gallery
ORIENT: float
TAGS: tomb_entry no_monster_gen
SUBST: + = ++++., = = +
KFEAT: O = enter_tomb
KMONS: 1 = mummy
KMONS: 2O = guardian mummy
MAP
cccc=cccccccc
cccc.....cccc
cccc..2..cccc
cccccccc+cccc
c..+.Oc1.+..c
c..c1ccc1c..c
c.2ccccccc2.c
c..c1ccc1c..c
c..+.1c1.+..c
cccc+ccc+cccc
cccc..2..cccc
cccc.....cccc
ccccccccccccc
ENDMAP

NAME: nicolae_tomb_entry_rubble_hallway
ORIENT: float
TAGS: tomb_entry no_monster_gen no_item_gen no_wall_fixup
NSUBST: R = 7:r / *:.
SUBST: r = xx..., . = .s
KITEM: s = stone q:1 / large rock q:1 w:5
RTILE: x = wall_pebble_darkgray
KFEAT: O = enter_tomb
MAP
ccccccccccccccccc
cccccccccccr...rc
c..rrr.rrr..RRR.c
+.r.r.r.r.rrROR.c
c.rr.rrr.rr.RRR.c
cccccccccccr...rc
ccccccccccccccccc
ENDMAP

NAME: nicolae_tomb_entry_unfolded_pyramid_diagonal
ORIENT: float
TAGS: tomb_entry no_monster_gen no_item_gen transparent
NSUBST: C = 1:. / *:c
KMONS: 1 = mummy
KMONS: O = guardian mummy
KFEAT: O = enter_tomb
MAP
       .....
      ...c...
     ...ccc...
    ...cc.cc...
   .1.cc...cc.1.
  ...cc..1..cc...
 ...cc+ccccc+cc...
...cc.cC...Cc.cc...
..cc..c.1.1.c..cc..
.++..1c..O..c1..cc.
..cc..c.1.1.c..cc..
...cc.cC...Cc.cc...
 ...cc+ccccc+cc...
  ...cc..1..cc...
   .1.cc...cc.1.
    ...cc.cc...
     ...ccc...
      ...c...
       .....
ENDMAP

NAME: nicolae_tomb_entry_unfolded_pyramid_orthogonal
ORIENT: float
TAGS: tomb_entry no_monster_gen no_item_gen transparent
NSUBST: C = 1:. / *:c
KMONS: 1 = mummy
KMONS: O = guardian mummy
KFEAT: O = enter_tomb
MAP
  .............
 .......1.......
..ccccccccccccc..
..c....+++....c..
..c.1.ccCcc.1.c..
..c..cc...cc..c..
..c.cc.....cc.c..
..c+c...1...c+c..
.1c+C..1O1..C+c1.
..c+c...1...c+c..
..c.cc.....cc.c..
..c..cc...cc..c..
..c.1.ccCcc.1.c..
..c....+++....c..
..cccccccccccc+..
 .......1.......
  .............
ENDMAP

##############################################################################
# The three Tomb levels: these should generally be of a confusing layout.
##############################################################################

##############################################################################
# Tomb:1
#
NAME:    tomb_1
PLACE:   Tomb:1

ORIENT:  encompass
TAGS:    no_dump
#
SHUFFLE: ([{, AB), ]}, _-
SUBST:   A=|*, B=|*
: if crawl.coinflip() then
SUBST:   I = I:900 6, N = N:900 6
SUBST:   J = J:750 6, O = O:750 6
SUBST:   K = K:550 6, P = P:550 6
SUBST:   L = L:300 6, Q = Q:300 6
: end
TILE:    FIJKL = dngn_sarcophagus_pedestal_left
TILE:    MNOPQ = dngn_sarcophagus_pedestal_right
COLOUR:  FIJKLMNOPQ = yellow
SUBST:   FIJKLMNOPQ = G
SUBST:   - = T
SUBST:   _ = F 6 ~:30 .:30
SUBST:   T = ~ .
SUBST:   t = ~ .:50
SUBST:   ' = 5 .:100
SUBST:   2 = 2 1:2 .
SUBST:   1 = 1 2:3 .
SUBST:   3 = 3., 4 = 4., 5 = 5.
#
MONS:    mummy, guardian mummy, mummy priest, sphinx, greater mummy
MONS:    silver statue / orange crystal statue / ice statue
#
: set_feature_name("granite_statue", "sarcophagus")
MAP
xxxxxxxxxxxxxxxxxxxxxxxxxxxxxxxxxxxxxxxxxxxxxxxxxxxxxxxxxxxxxxxxxxxxxxxxxxxxxxxx
xxxxxxxxxxxxxxxxxxxxxxxxxxxxxxxxxxxxxxxxxxxxxxxxxxxxxxxxxxxxxxxxxxxxxxxxxxxxxxxx
xxxxxxxxxxxxxxxxxxxxxxxxxxxxxxxxxxxxxxxxxxxxxxxxxxxxxxxxxxxxxxxxxxxxxxxxxxxxxxxx
xxxxxxxxxxxxxxxxxxxxxxxxxxxxxxxxxxxxxxxxxxxxxxxxxxxxxxxxxxxxxxxxxxxxxxxxxxxxxxxx
xxxxxxxxxxxxxxxxxxxxxxxxxxxxxxxxxxxxxxxxxxxxxxxxxxxxxxxxxxxxxxxxxxxxxxxxxxxxxxxx
xxxxxxxxxxxxxxxxxxxxxxxxxxxxxxxxxxxxxxxxxxxxxxxxxxxxxxxxxxxxxxxxxxxxxxxxxxxxxxxx
xxxxxxxxxxxxxxxxxxxxxxxxxxxxxxxxxxxxxxxxxxxxxxxxxxxxxxxxxxxxxxxxxxxxxxxxxxxxxxxx
xxxxxxxxx(.............................[..............................{xxxxxxxxx
xxxxxxxxx..............................................................xxxxxxxxx
xxxxxxxxx..............................................................xxxxxxxxx
xxxxxxxxx..............................................................xxxxxxxxx
xxxxxxxxx..............................................................xxxxxxxxx
xxxxxxxxx..........ccccccccccccccccccccccccccccccccccccccccccc.........xxxxxxxxx
xxxxxxxxx..........ccccccccccccccccccccccccccccccccccccccccccc.........xxxxxxxxx
xxxxxxxxx..........cc'''''''''''''''''''''''''''''''''''''''cc.........xxxxxxxxx
xxxxxxxxx..........cc'''''''''''''''''''''''''''''''''''''''cc.........xxxxxxxxx
xxxxxxxxx..........cc''ccccccccccccccccccccccccccccccccccc''cc.........xxxxxxxxx
xxxxxxxxx..........cc''c..ttttttttttc................ctt)c''cc.........xxxxxxxxx
xxxxxxxxx..........cc''c..ccccccccctc..3..........2..ct-tc''cc.........xxxxxxxxx
xxxxxxxxx..........cc''c..cA22c111ctc....3..........5c_ttc''cc.........xxxxxxxxx
xxxxxxxxx..........cc''c..c2c222ctttc......2.........+cccc''cc.........xxxxxxxxx
xxxxxxxxx..........cc''c..ccccccccccc.5........3...3..5..c''cc.........xxxxxxxxx
xxxxxxxxx..........cc''c.................................c''cc.........xxxxxxxxx
xxxxxxxxx..........cc''c............3.............3....2.c''cc.........xxxxxxxxx
xxxxxxxxx..........cc''cccccccccccccc.......2...2........c''cc.........xxxxxxxxx
xxxxxxxxx..........cc''c............c....................c''cc.........xxxxxxxxx
xxxxxxxxx..........cc''c............c.................3..c''cc.........xxxxxxxxx
xxxxxxxxx..........cc''c..cccccccc..c..........2..2......c''cc.........xxxxxxxxx
xxxxxxxxx..........cc''c..ctttc1Bc..c....................c''cc.........xxxxxxxxx
xxxxxxxxx..........cc''c..ctctc11c..c...3.......3........c''cc.........xxxxxxxxx
xxxxxxxxx..........cc''c..ctct11cc..c..............2.....c''cc.........xxxxxxxxx
xxxxxxxxx..........cc''c..ctcccccc..c.......2............c''cc.........xxxxxxxxx
xxxxxxxxx..........cc''c..cttttttt..c.3...............2..c''cc.........xxxxxxxxx
xxxxxxxxx..........cc''c..ccccccccccc....2.....3.........c''cc.........xxxxxxxxx
xxxxxxxxx..........cc''c.......5.........................c''cc.........xxxxxxxxx
xxxxxxxxx..........cc''c.................................c''cc.........xxxxxxxxx
xxxxxxxxx..........cc''ccccccccccccccTTTTTTTcccccccccccccc''cc.........xxxxxxxxx
xxxxxxxxx..........cc''c'''''''''''ccc+++++ccc'''''''''''c''cc.........xxxxxxxxx
xxxxxxxxx..........cc''c'''''''''''cc.2...2.cc'''''''''''c''cc.........xxxxxxxxx
xxxxxxxxx..........cc''c''ccccccc''cc.L...Q.cc''ccccccc''c''cc.........xxxxxxxxx
xxxxxxxxx..........cc''c''cc.322c''cc.......cc''c22.'cc''c''cc.........xxxxxxxxx
xxxxxxxxx..........cc''c''c]'c22c''cc.2...2.cc''c22c.}c''c''cc.........xxxxxxxxx
xxxxxxxxx..........cc''c''cccc''c''cc.K...P.cc''c3'cccc''c''cc.........xxxxxxxxx
xxxxxxxxx..........cc''c''''''''c''cc.......cc''c''''''''c''cc.........xxxxxxxxx
xxxxxxxxx..........cc''c''''''''c''cc.2...2.cc''c''''''''c''cc.........xxxxxxxxx
xxxxxxxxx..........cc''cccccccccc''cc.J...O.cc''cccccccccc''cc.........xxxxxxxxx
xxxxxxxxx..........cc''''''''''''''cc.......cc''''''''''''''cc.........xxxxxxxxx
xxxxxxxxx..........cc''''''''''''''cc.......cc''''''''''''''cc.........xxxxxxxxx
xxxxxxxxx..........cccccccccccccccccc.I...N.cccccccccccccccccc.........xxxxxxxxx
xxxxxxxxx..........cccccccccccccccccc.......cccccccccccccccccc.........xxxxxxxxx
xxxxxxxxx.............................4...4............................xxxxxxxxx
xxxxxxxxx.............................F...M............................xxxxxxxxx
xxxxxxxxx...........................4.4...4.4..........................xxxxxxxxx
xxxxxxxxx..............................................................xxxxxxxxx
xxxxxxxxx..............................................................xxxxxxxxx
xxxxxxxxx...........................4..V.V..4..........................xxxxxxxxx
xxxxxxxxx..............................................................xxxxxxxxx
xxxxxxxxx.............................4...4............................xxxxxxxxx
xxxxxxxxx..............................................................xxxxxxxxx
xxxxxxxxx...........................4.......4..........................xxxxxxxxx
xxxxxxxxx..............................................................xxxxxxxxx
xxxxxxxxx..............................................................xxxxxxxxx
xxxxxxxxxxxxxxxxxxxxxxxxxxxxxxxxxxxxxxxxxxxxxxxxxxxxxxxxxxxxxxxxxxxxxxxxxxxxxxxx
xxxxxxxxxxxxxxxxxxxxxxxxxxxxxxxxxxxxxxxxxxxxxxxxxxxxxxxxxxxxxxxxxxxxxxxxxxxxxxxx
xxxxxxxxxxxxxxxxxxxxxxxxxxxxxxxxxxxxxxxxxxxxxxxxxxxxxxxxxxxxxxxxxxxxxxxxxxxxxxxx
xxxxxxxxxxxxxxxxxxxxxxxxxxxxxxxxxxxxxxxxxxxxxxxxxxxxxxxxxxxxxxxxxxxxxxxxxxxxxxxx
xxxxxxxxxxxxxxxxxxxxxxxxxxxxxxxxxxxxxxxxxxxxxxxxxxxxxxxxxxxxxxxxxxxxxxxxxxxxxxxx
xxxxxxxxxxxxxxxxxxxxxxxxxxxxxxxxxxxxxxxxxxxxxxxxxxxxxxxxxxxxxxxxxxxxxxxxxxxxxxxx
xxxxxxxxxxxxxxxxxxxxxxxxxxxxxxxxxxxxxxxxxxxxxxxxxxxxxxxxxxxxxxxxxxxxxxxxxxxxxxxx
xxxxxxxxxxxxxxxxxxxxxxxxxxxxxxxxxxxxxxxxxxxxxxxxxxxxxxxxxxxxxxxxxxxxxxxxxxxxxxxx
ENDMAP

###############################################################################
# Tomb:2
#
NAME:    tomb_2
PLACE:   Tomb:2
# Can be rotated!
ORIENT:  encompass
TAGS:    no_dump
#
NSUBST:  A = [ / '
SHUFFLE: Ww/Yy/Zz, Uu/Vv, Qq/Rr/Ss
SUBST:   W=', w=c, Y=T, y=+, Z=T, z=+
SUBST:   U=', u=c, V=T, v=+
SUBST:   Q=', q=c, R=T, r=+, S=T, s=+
#
SHUFFLE: ])}def
SUBST:   d=", e=", f="
#
SUBST:   T = ~ .
SUBST:   ' = ~ ':100
SUBST:   ' = 1:5 2:5 3:1 .:89
SUBST:   " = ~ ":50
SUBST:   " = 2:3 3:1 .:96
#
# Number of ' symbols is 211+3=214, hence statistically in the lower
# circumference we'll have 10.7 mummies, another 10.7 guardian mummies
# and 2.1 mummy priests.
# Number of " symbols is 205+3=208, hence the upper circumference
# has in mean 4.0 mummy priests and 8.3 guardian mummies.
#
# Perhaps to do: use KFEAT to make mummies possibly appear at T spots.
#                have clustering of 1, 2 in the lower area as before?
#
MONS: mummy, guardian mummy, mummy priest, greater mummy
#
MAP
XXXXXXXXXXXXXXXXXXXXXXXXXXXXXXXXXXXXXXXXXXXXXXXXXXXXXXXXXXXXXXXXXXXXXX
XXXXXXXXXXXXXXXXXXXXXXXXXXXXXXXXXXXXXXXXXXXXXXXXXXXXXXXXXXXXXXXXXXXXXX
XXXXXXXXXXXXXXXXXXXXXXXXXXXXXXXXXXXXXXXXXXXXXXXXXXXXXXXXXXXXXXXXXXXXXX
XXXXXXXXXXXXXXXXXXXXXXXXXXXXXXXXXXXXXXXXXXXXXXXXXXXXXXXXXXXXXXXXXXXXXX
XXXXXXXXXXXXXXXXXXXXXXXXXXXXXXXXXXXXXXXXXXXXXXXXXXXXXXXXXXXXXXXXXXXXXX
XXXXXXXXXXXXXXXXXXXXXXXXXXXXXXXXXXXXXXXXXXXXXXXXXXXXXXXXXXXXXXXXXXXXXX
XXXXXXXXXXXXXXXXXXXXXXXXXXXXXXXXXXXXXXXXXXXXXXXXXXXXXXXXXXXXXXXXXXXXXX
XXXXXXXXXXXXXXXXXXXXXXXXXXXXXXXXXXXXXXXXXXXXXXXXXXXXXXXXXXXXXXXXXXXXXX
XXXXXXXXXXXXXXXXXXXXXXXXXXXXXXXXXXXXXXXXXXXXXXXXXXXXXXXXXXXXXXXXXXXXXX
XXXXXXXXXXXXXXXXXXXXXXXXXXXXXXXXXXXXXXXXXXXXXXXXXXXXXXXXXXXXXXXXXXXXXX
XXXXXXXXXXXXXXXXXXXXXXXXXXXXXXXXXXXXXXXXXXXXXXXXXXXXXXXXXXXXXXXXXXXXXX
XXXXXXXXXXXXXXXXXXXXXXXXXXXXXXXXXXXXXXXXXXXXXXXXXXXXXXXXXXXXXXXXXXXXXX
XXXXXXXXXXXXXXcccccccccccccccccccccccccccccccccccccccccccXXXXXXXXXXXXX
XXXXXXXXXXXXXXcccccccccccccccccccccccccccccccccccccccccccXXXXXXXXXXXXX
XXXXXXXXXXXXXXcc""""c""""""c"""""{""""c""""""""c"""""""ccXXXXXXXXXXXXX
XXXXXXXXXXXXXXcc""""c"""""TcT""""""""TcT""""""TcT""""""ccXXXXXXXXXXXXX
XXXXXXXXXXXXXXcc""""c"""2"T+T""""""""T+T""2"""T+T""""""ccXXXXXXXXXXXXX
XXXXXXXXXXXXXXcc"""TcT""""TcT""""""""TcT""""""TcT""""""ccXXXXXXXXXXXXX
XXXXXXXXXXXXXXcc""TT+T"""""c""""""""""c""""""""c"""""""ccXXXXXXXXXXXXX
XXXXXXXXXXXXXXccccc+ccccccccccccccccccccccccccccccc""""ccXXXXXXXXXXXXX
XXXXXXXXXXXXXXcc""TTc.............................c"3""ccXXXXXXXXXXXXX
XXXXXXXXXXXXXXcc""""c.............................c""""ccXXXXXXXXXXXXX
XXXXXXXXXXXXXXcc""3"c..xxx4.................4xxx..c"""fccXXXXXXXXXXXXX
XXXXXXXXXXXXXXcc""""c..xxx...................xxx..c""""ccXXXXXXXXXXXXX
XXXXXXXXXXXXXXcc""""c..xxx.........1.........xxx..c)""}ccXXXXXXXXXXXXX
XXXXXXXXXXXXXXcc""""c..xxx.....2.......2.....xxx..cccccccXXXXXXXXXXXXX
XXXXXXXXXXXXXXcc""""c.............................c''''ccXXXXXXXXXXXXX
XXXXXXXXXXXXXXcce"""c.............................cT'''ccXXXXXXXXXXXXX
XXXXXXXXXXXXXXcc""""c........X...........X........+T'''ccXXXXXXXXXXXXX
XXXXXXXXXXXXXXcc]""dc.............................cT'''ccXXXXXXXXXXXXX
XXXXXXXXXXXXXXccccccc.....3........(........3.....c''''ccXXXXXXXXXXXXX
XXXXXXXXXXXXXXcc''''c.............................c'QQQccXXXXXXXXXXXXX
XXXXXXXXXXXXXXcc'''Tc........X...........X........cccqcccXXXXXXXXXXXXX
XXXXXXXXXXXXXXcc'''T+.............................c'QQQccXXXXXXXXXXXXX
XXXXXXXXXXXXXXcc'''Tc.............................c''''ccXXXXXXXXXXXXX
XXXXXXXXXXXXXXcc'ZZZc..xxx.....2.......2.....xxx..c''''ccXXXXXXXXXXXXX
XXXXXXXXXXXXXXcccczcc..xxx.........1.........xxx..c''''ccXXXXXXXXXXXXX
XXXXXXXXXXXXXXcc'ZZZc..xxx...................xxx..c''''ccXXXXXXXXXXXXX
XXXXXXXXXXXXXXccA'''c..xxx4.................4xxx..c''''ccXXXXXXXXXXXXX
XXXXXXXXXXXXXXcc'YYYc.............................c''''ccXXXXXXXXXXXXX
XXXXXXXXXXXXXXccccycc.............................cRRRAccXXXXXXXXXXXXX
XXXXXXXXXXXXXXcc'YYYc.............................ccrccccXXXXXXXXXXXXX
XXXXXXXXXXXXXXcc''''ccccc+ccccccccccccccc+cccccccccRRR'ccXXXXXXXXXXXXX
XXXXXXXXXXXXXXcc''''''c'TTTc''''''''''''cTT''''''c'''''ccXXXXXXXXXXXXX
XXXXXXXXXXXXXXcc'''''WcW''UcU''''''''''VcV''''''ScS''''ccXXXXXXXXXXXXX
XXXXXXXXXXXXXXcc'''''WwW''UuU''''''''''VvV''''''SsS''''ccXXXXXXXXXXXXX
XXXXXXXXXXXXXXcc'''''WcW''UcU''''''''''VcV''''''ScS''''ccXXXXXXXXXXXXX
XXXXXXXXXXXXXXccA'''''c''''cA'''''''''''c''''''''c''''AccXXXXXXXXXXXXX
XXXXXXXXXXXXXXcccccccccccccccccccccccccccccccccccccccccccXXXXXXXXXXXXX
XXXXXXXXXXXXXXcccccccccccccccccccccccccccccccccccccccccccXXXXXXXXXXXXX
XXXXXXXXXXXXXXXXXXXXXXXXXXXXXXXXXXXXXXXXXXXXXXXXXXXXXXXXXXXXXXXXXXXXXX
XXXXXXXXXXXXXXXXXXXXXXXXXXXXXXXXXXXXXXXXXXXXXXXXXXXXXXXXXXXXXXXXXXXXXX
XXXXXXXXXXXXXXXXXXXXXXXXXXXXXXXXXXXXXXXXXXXXXXXXXXXXXXXXXXXXXXXXXXXXXX
XXXXXXXXXXXXXXXXXXXXXXXXXXXXXXXXXXXXXXXXXXXXXXXXXXXXXXXXXXXXXXXXXXXXXX
XXXXXXXXXXXXXXXXXXXXXXXXXXXXXXXXXXXXXXXXXXXXXXXXXXXXXXXXXXXXXXXXXXXXXX
XXXXXXXXXXXXXXXXXXXXXXXXXXXXXXXXXXXXXXXXXXXXXXXXXXXXXXXXXXXXXXXXXXXXXX
XXXXXXXXXXXXXXXXXXXXXXXXXXXXXXXXXXXXXXXXXXXXXXXXXXXXXXXXXXXXXXXXXXXXXX
XXXXXXXXXXXXXXXXXXXXXXXXXXXXXXXXXXXXXXXXXXXXXXXXXXXXXXXXXXXXXXXXXXXXXX
XXXXXXXXXXXXXXXXXXXXXXXXXXXXXXXXXXXXXXXXXXXXXXXXXXXXXXXXXXXXXXXXXXXXXX
XXXXXXXXXXXXXXXXXXXXXXXXXXXXXXXXXXXXXXXXXXXXXXXXXXXXXXXXXXXXXXXXXXXXXX
XXXXXXXXXXXXXXXXXXXXXXXXXXXXXXXXXXXXXXXXXXXXXXXXXXXXXXXXXXXXXXXXXXXXXX
XXXXXXXXXXXXXXXXXXXXXXXXXXXXXXXXXXXXXXXXXXXXXXXXXXXXXXXXXXXXXXXXXXXXXX
XXXXXXXXXXXXXXXXXXXXXXXXXXXXXXXXXXXXXXXXXXXXXXXXXXXXXXXXXXXXXXXXXXXXXX
XXXXXXXXXXXXXXXXXXXXXXXXXXXXXXXXXXXXXXXXXXXXXXXXXXXXXXXXXXXXXXXXXXXXXX
XXXXXXXXXXXXXXXXXXXXXXXXXXXXXXXXXXXXXXXXXXXXXXXXXXXXXXXXXXXXXXXXXXXXXX
XXXXXXXXXXXXXXXXXXXXXXXXXXXXXXXXXXXXXXXXXXXXXXXXXXXXXXXXXXXXXXXXXXXXXX
XXXXXXXXXXXXXXXXXXXXXXXXXXXXXXXXXXXXXXXXXXXXXXXXXXXXXXXXXXXXXXXXXXXXXX
XXXXXXXXXXXXXXXXXXXXXXXXXXXXXXXXXXXXXXXXXXXXXXXXXXXXXXXXXXXXXXXXXXXXXX
XXXXXXXXXXXXXXXXXXXXXXXXXXXXXXXXXXXXXXXXXXXXXXXXXXXXXXXXXXXXXXXXXXXXXX
XXXXXXXXXXXXXXXXXXXXXXXXXXXXXXXXXXXXXXXXXXXXXXXXXXXXXXXXXXXXXXXXXXXXXX
ENDMAP


#############################################################################
# Tomb:3
#
NAME:    tomb_3
PLACE:   Tomb:3
ORIENT:  encompass
TAGS:    no_rotate no_dump
#
SUBST:   ' : " $ ':80
SUBST:   ' = " $
SUBST:   " = ~:1 .
SUBST:   $ = *:2 |:1 $:17
#
MONS:    mummy, guardian mummy, mummy priest, greater mummy
#
KITEM:   $ = $ no_pickup
KITEM:   * = * no_pickup
KITEM:   | = | no_pickup
KMASK:   O = no_item_gen
KITEM:   O = golden rune of Zot
MAP
XXXXXXXXXXXXXXXXXXXXXXXXXXXXXXXXXXXXXXXXXXXXXXXXXXXXXXXXXXXXXXXXXXXXXX
XXXXXXXXXXXXXXXXXXXXXXXXXXXXXXXXXXXXXXXXXXXXXXXXXXXXXXXXXXXXXXXXXXXXXX
XXXXXXXXXXXXXXXXXXXXXXXXXXXXXXXXXXXXXXXXXXXXXXXXXXXXXXXXXXXXXXXXXXXXXX
XXXXXXXXXXXXXXXXXXXXXXXXXXXXXXXXXXXXXXXXXXXXXXXXXXXXXXXXXXXXXXXXXXXXXX
XXXXXXXXXXXXXXXXXXXXXXXXXXXXXXXXXXXXXXXXXXXXXXXXXXXXXXXXXXXXXXXXXXXXXX
XXXXXXXXXXXXXXXXXXXXXXXXXXXXXXXXXXXXXXXXXXXXXXXXXXXXXXXXXXXXXXXXXXXXXX
XXXXXXXXXXXXXXXXXXXXXXXXXXXXXXXXXXXXXXXXXXXXXXXXXXXXXXXXXXXXXXXXXXXXXX
XXXXXXXXXXXXXXXXXXXXXXXXXXXXXXXXXXXXXXXXXXXXXXXXXXXXXXXXXXXXXXXXXXXXXX
XXXXXXXXXXXXXXXXXXXXXXXXXXXXXXXXXXXXXXXXXXXXXXXXXXXXXXXXXXXXXXXXXXXXXX
XXXXXXXXXXXXXXXXXXXXXXXXXXXXXXXXXXXXXXXXXXXXXXXXXXXXXXXXXXXXXXXXXXXXXX
XXXXXXXXXXXXXXXXXXXXXXXXXXXXXXXXXXXXXXXXXXXXXXXXXXXXXXXXXXXXXXXXXXXXXX
XXXXXXXXXXXXXXXXXXXXXXXXXXXXXXXXXXXXXXXXXXXXXXXXXXXXXXXXXXXXXXXXXXXXXX
XXXXXXXXXXXXXXcccccccccccccccccccccccccccccccccccccccccccXXXXXXXXXXXXX
XXXXXXXXXXXXXXcccccccccccccccccccccccccccccccccccccccccccXXXXXXXXXXXXX
XXXXXXXXXXXXXXccccccc.............................cccccccXXXXXXXXXXXXX
XXXXXXXXXXXXXXcccc...............cccccc..............ccccXXXXXXXXXXXXX
XXXXXXXXXXXXXXccc...............cccccccc..............cccXXXXXXXXXXXXX
XXXXXXXXXXXXXXccc.......4......ccccO4cccc......4......cccXXXXXXXXXXXXX
XXXXXXXXXXXXXXccc............cccc......cccc...........cccXXXXXXXXXXXXX
XXXXXXXXXXXXXXcc............cccc........cccc...........ccXXXXXXXXXXXXX
XXXXXXXXXXXXXXcc............cccc........cccc...........ccXXXXXXXXXXXXX
XXXXXXXXXXXXXXcc...........cccc..444444..cccc..........ccXXXXXXXXXXXXX
XXXXXXXXXXXXXXcc.......................................ccXXXXXXXXXXXXX
XXXXXXXXXXXXXXcc.......................................ccXXXXXXXXXXXXX
XXXXXXXXXXXXXXcc.................222222................ccXXXXXXXXXXXXX
XXXXXXXXXXXXXXccc................223322...............cccXXXXXXXXXXXXX
XXXXXXXXXXXXXXccc...3............223322............3..cccXXXXXXXXXXXXX
XXXXXXXXXXXXXXcccc...............222222..............ccccXXXXXXXXXXXXX
XXXXXXXXXXXXXXcccc....2..........................2...ccccXXXXXXXXXXXXX
XXXXXXXXXXXXXXcccccc....2......................2....cccccXXXXXXXXXXXXX
XXXXXXXXXXXXXXcccccccc............................cccccccXXXXXXXXXXXXX
XXXXXXXXXXXXXXccccccccc+ccc..................ccc+ccccccccXXXXXXXXXXXXX
XXXXXXXXXXXXXXcccccccc""""cc................cc""""cccccccXXXXXXXXXXXXX
XXXXXXXXXXXXXXcccccc"""""""cc22222222222222cc"""""'$cccccXXXXXXXXXXXXX
XXXXXXXXXXXXXXcccc""""""""""cc............cc"""""""'$ccccXXXXXXXXXXXXX
XXXXXXXXXXXXXXcccc'""""""""""cc..........cc""""""""'$ccccXXXXXXXXXXXXX
XXXXXXXXXXXXXXccc$''""""""""""cc........cc"""""""""'$$cccXXXXXXXXXXXXX
XXXXXXXXXXXXXXccc$$$'""""""""""cc222222cc""""""""''$$$cccXXXXXXXXXXXXX
XXXXXXXXXXXXXXccc|$$$''"""""""""c......c"""""""''$$$$$cccXXXXXXXXXXXXX
XXXXXXXXXXXXXXccc||$$$$'""""""""c......c""""""'$$$$$$$cccXXXXXXXXXXXXX
XXXXXXXXXXXXXXccc|||||$$'"""""""c......c"""""'$$$$$$$$cccXXXXXXXXXXXXX
XXXXXXXXXXXXXXcccc|||||$'"""""""c......c""""'$$$$$$$$ccccXXXXXXXXXXXXX
XXXXXXXXXXXXXXccccc||||$$'""""""c......c""""'$$$$$$$cccccXXXXXXXXXXXXX
XXXXXXXXXXXXXXcccccc||||$'""""""c......c""""'$$$$$$ccccccXXXXXXXXXXXXX
XXXXXXXXXXXXXXccccccc|||$$'"""""c......c"""'$$$$$$cccccccXXXXXXXXXXXXX
XXXXXXXXXXXXXXcccccccc|||$'""""cc..{...cc""'$$$$$ccccccccXXXXXXXXXXXXX
XXXXXXXXXXXXXXccccccccc||$'""""cc...(..cc"'$$$$$cccccccccXXXXXXXXXXXXX
XXXXXXXXXXXXXXcccccccccc|$'""cccc..[...cccc$$$$ccccccccccXXXXXXXXXXXXX
XXXXXXXXXXXXXXcccccccccccccccccccccccccccccccccccccccccccXXXXXXXXXXXXX
XXXXXXXXXXXXXXcccccccccccccccccccccccccccccccccccccccccccXXXXXXXXXXXXX
XXXXXXXXXXXXXXXXXXXXXXXXXXXXXXXXXXXXXXXXXXXXXXXXXXXXXXXXXXXXXXXXXXXXXX
XXXXXXXXXXXXXXXXXXXXXXXXXXXXXXXXXXXXXXXXXXXXXXXXXXXXXXXXXXXXXXXXXXXXXX
XXXXXXXXXXXXXXXXXXXXXXXXXXXXXXXXXXXXXXXXXXXXXXXXXXXXXXXXXXXXXXXXXXXXXX
XXXXXXXXXXXXXXXXXXXXXXXXXXXXXXXXXXXXXXXXXXXXXXXXXXXXXXXXXXXXXXXXXXXXXX
XXXXXXXXXXXXXXXXXXXXXXXXXXXXXXXXXXXXXXXXXXXXXXXXXXXXXXXXXXXXXXXXXXXXXX
XXXXXXXXXXXXXXXXXXXXXXXXXXXXXXXXXXXXXXXXXXXXXXXXXXXXXXXXXXXXXXXXXXXXXX
XXXXXXXXXXXXXXXXXXXXXXXXXXXXXXXXXXXXXXXXXXXXXXXXXXXXXXXXXXXXXXXXXXXXXX
XXXXXXXXXXXXXXXXXXXXXXXXXXXXXXXXXXXXXXXXXXXXXXXXXXXXXXXXXXXXXXXXXXXXXX
XXXXXXXXXXXXXXXXXXXXXXXXXXXXXXXXXXXXXXXXXXXXXXXXXXXXXXXXXXXXXXXXXXXXXX
XXXXXXXXXXXXXXXXXXXXXXXXXXXXXXXXXXXXXXXXXXXXXXXXXXXXXXXXXXXXXXXXXXXXXX
XXXXXXXXXXXXXXXXXXXXXXXXXXXXXXXXXXXXXXXXXXXXXXXXXXXXXXXXXXXXXXXXXXXXXX
XXXXXXXXXXXXXXXXXXXXXXXXXXXXXXXXXXXXXXXXXXXXXXXXXXXXXXXXXXXXXXXXXXXXXX
XXXXXXXXXXXXXXXXXXXXXXXXXXXXXXXXXXXXXXXXXXXXXXXXXXXXXXXXXXXXXXXXXXXXXX
XXXXXXXXXXXXXXXXXXXXXXXXXXXXXXXXXXXXXXXXXXXXXXXXXXXXXXXXXXXXXXXXXXXXXX
XXXXXXXXXXXXXXXXXXXXXXXXXXXXXXXXXXXXXXXXXXXXXXXXXXXXXXXXXXXXXXXXXXXXXX
XXXXXXXXXXXXXXXXXXXXXXXXXXXXXXXXXXXXXXXXXXXXXXXXXXXXXXXXXXXXXXXXXXXXXX
XXXXXXXXXXXXXXXXXXXXXXXXXXXXXXXXXXXXXXXXXXXXXXXXXXXXXXXXXXXXXXXXXXXXXX
XXXXXXXXXXXXXXXXXXXXXXXXXXXXXXXXXXXXXXXXXXXXXXXXXXXXXXXXXXXXXXXXXXXXXX
XXXXXXXXXXXXXXXXXXXXXXXXXXXXXXXXXXXXXXXXXXXXXXXXXXXXXXXXXXXXXXXXXXXXXX
XXXXXXXXXXXXXXXXXXXXXXXXXXXXXXXXXXXXXXXXXXXXXXXXXXXXXXXXXXXXXXXXXXXXXX
ENDMAP
