
# 6x6 room filled with 8s and 9s testing level generation
NAME:     vaults_room_test_orient_n
TAGS:     vaults_room allow_dup vaults_orient_n
MAP
......
......
......
......
......
o....o
ENDMAP

NAME:     vaults_room_test_rect
TAGS:     vaults_room_test allow_dup
MAP
......
......
......
......
......
......
......
o....o
ENDMAP
