
# 6x6 room filled with 8s and 9s testing level generation
NAME:     vaults_room_test_monsters
TAGS:     vaults_room allow_dup
SUBST:    . = .....889
MAP
......
......
......
......
......
......
ENDMAP
