# In the buggy case, the monster oscillates between 1 and 2.
NAME: monster_plant_pathfind
ORIENT: encompass
MONS: generate_awake hippogriff, nothing
KMONS: P = plant
# Just to shut up level compiler sanity checks.
TAGS: monster_plant_pathfind
MAP
xxxxx
xxP{x
x2PPx
x.1xx
xxxxx
ENDMAP
